1111111
1E0E0E1
1000001
100P001
1CCCCC1
1111111