111111
1C0P11
10R011
1E0T11
111111